..a...b....c...
.a.a.b..c.c.c..
..a.b....c.....
...b...d...d...
.c.c.c...d.d.d.
..b.b..d...d...
....c..d.d.....
a..a....b...c..
.a...a..b.b....
..a.a...b......
....c...d...a..
c.c.c...d.d.d..
..b...d....c...
...b.b.c.c.....
c..c....d....a.